11111111111111111111111111111111111111111111111111
11101P00000000000000C00001101111011100101010111011
11110000110110010001001100011011000101000000110111
10101000000110110000100110110110000011011001001001
10110000100010110010110100110011011100011111101111
1010000101101010000100111101100000011100C001001001
10110010101110011000100111110011100000110011101001
100C0000010110001001110001111010100101000101001011
10100000000000000000100100101000001010000100100101
11111110010010000001100110111100110001100011110011
101100100100001000000000000000C1111011100111011101
11110110011010111101111111000101010100000111010001
11011010010110010101111000100000000010000000010101
10101001100100011000110100010011000110000011000111
11101010111111110101000010110011110001000110001001
10011000110100101100001111101110101110010000101011
10100101001111010100001111101000101100100011000111
10100011100000000000010011011011010000100111110101
10110110010100010101000000011100000010000010110001
11001000110110110100111110000100111110000010001101
10110010101111000000010101111011101101100110100101
11111011010010000101100111000010011011100110001111
10011011001011010100110011110011100101100001011101
11110001011011000101111011110101011100010101000001
10010C00000000000001111110001010110001000010101101
10001001110110010000000000000000001000110101000011
11100101001010000001010110101001101010000001001001
110110011100101010011101010010001000000000000C0111
111011010000100011100011101101011010000000000000E1
11111111111111111111111111111111111111111111111111