11111111111111111111111
11000000000000000000011
11000000000000000000011
11000000000000000000011
11000000000000000000011
11111111111111111111111