11111111111111111111111
11CCCCCCCCCCCCCCCCCCC11
11CCCCCCPCCCCCCCCCCCC11
11CCCCCCCCCECCCCCCCCC11
11CCCCCCCCCCCCCCCCCCC11
11111111111111111111111