11111111111111111111111
11P0CCCCCC0CCCCCCCCCC11
1111C0C001CCC00000CCC11
11CCCCCCCCECCCCC0CCCC11
11CCCCCCCCCCCCCCCCCCC11
11111111111111111111111