11111111111111111111111
11000000000000000000011
1100000000P000000000011
11000000000000000000011
11000000C00E00000000011
11111111111111111111111