11111111111111111111111
11000000000000000000011
110000000000P0000000011
110000000000E0000000011
110000000000C0000000011
11111111111111111111111