1111111111111
1010C00000001
10000000C1101
100P00E000C11
1000000100001
1111111111111