1111111111111
10010C0000001
10P00000C0001
100110E000C11
1000000000001
1111111111111