1111111111111
1010C00000001
10000000C1111
100P00E000C11
1000000000001
1111111111111