1111111111111
10P10C0000001
10000000C0001
100110E000C11
1000000000001
1111111111111