111111111111111111111111111111111111111111111111111111111111111111111111111111111111
10000000001000000C101011111111111111111111111111111111111111111111111111111111111111
111111101010111111101011111111111111111111111111111111111111111111111111111111111111
1P0000001000100000001011111111111111111111111111111111111111111111111111111111111111
111110101111111101101C11111111111111111111111111111111111111111111111111111111111111
100000100000100000101011111111111111111111111111111111111111111111111111111111111111
101110111111101110111011111111111111111111111111111111111111111111111111111111111111
100010101000001010100011111111111111111111111111111111111111111111111111111111111111
101110101011111010101111111111111111111111111111111111111111111111111111111111111111
101000001010100000001011111111111111111111111111111111111111111111111111111111111111
101011111010100001101011111111111111111111111111111111111111111111111111111111111111
101C10000000101000101011111111111111111111111111111111111111111111111111111111111111
111010111110101110111011111111111111111111111111111111111111111111111111111111111111
100010100010101010000011111111111111111111111111111111111111111111111111111111111111
101010111011101011111111111111111111111111111111111111111111111111111111111111111111
1010100010100000100C0011111111111111111111111111111111111111111111111111111111111111
101011101010111110111011111111111111111111111111111111111111111111111111111111111111
101010001000100000000E11111111111111111111111111111111111111111111111111111111111111
101010111110111010111111111111111111111111111111111111111111111111111111111111111111
101000100000000010000011111111111111111111111111111111111111111111111111111111111111
111111111111111111111111111111111111111111111111111111111111111111111111111111111111
111111111111111111111111111111111111111111111111111111111111111111111111111111111111
111111111111111111111111111111111111111111111111111111111111111111111111111111111111
111111111111111111111111111111111111111111111111111111111111111111111111111111111111
111111111111111111111111111111111111111111111111111111111111111111111111111111111111
111111111111111111111111111111111111111111111111111111111111111111111111111111111111
111111111111111111111111111111111111111111111111111111111111111111111111111111111111
111111111111111111111111111111111111111111111111111111111111111111111111111111111111
111111111111111111111111111111111111111111111111111111111111111111111111111111111111
111111111111111111111111111111111111111111111111111111111111111111111111111111111111
111111111111111111111111111111111111111111111111111111111111111111111111111111111111
111111111111111111111111111111111111111111111111111111111111111111111111111111111111
111111111111111111111111111111111111111111111111111111111111111111111111111111111111
111111111111111111111111111111111111111111111111111111111111111111111111111111111111
111111111111111111111111111111111111111111111111111111111111111111111111111111111111
111111111111111111111111111111111111111111111111111111111111111111111111111111111111
111111111111111111111111111111111111111111111111111111111111111111111111111111111111
111111111111111111111111111111111111111111111111111111111111111111111111111111111111
111111111111111111111111111111111111111111111111111111111111111111111111111111111111
111111111111111111111111111111111111111111111111111111111111111111111111111111111111
111111111111111111111111111111111111111111111111111111111111111111111111111111111111
111111111111111111111111111111111111111111111111111111111111111111111111111111111111
111111111111111111111111111111111111111111111111111111111111111111111111111111111111
111111111111111111111111111111111111111111111111111111111111111111111111111111111111
111111111111111111111111111111111111111111111111111111111111111111111111111111111111
111111111111111111111111111111111111111111111111111111111111111111111111111111111111
111111111111111111111111111111111111111111111111111111111111111111111111111111111111
111111111111111111111111111111111111111111111111111111111111111111111111111111111111
111111111111111111111111111111111111111111111111111111111111111111111111111111111111